>_UUUUUUNNNNN
<_UUUUUNPPPPPS
>_UNNNNNPNNNN
<_NPPPPPPNUUU
>_NPNNNNNNNNU
>_NPPPPPPPPPN
>_UNNNNNNNNPN
<_UUUUUUNPPPN
>_NNNNNNNPNNU
<EPPPPPPPPNUU
>_NNNNNNNNUUU