>NNNNNNNNNN
<NNNNNNNNPPS
<NNNNNNPPPN
<NNNNNNPNNN
>NNEPPPPNNN
>NNNNNNNNNN

