 NNNNNNNNNN
 NNNNNNNNPPS
<NNNPPPPPPN
 NNNPNNNNNN
>NNNPPPPENN
 NNNNNNNNNN

