<______NNNNNNNNNNNNNNNN
<______NNNNNNNNNNNPPPPPS
<______NPPPPPPPPPPPNNNN
>______NPNNNNNNNNNNNNNN
>______NPNNNNUUUUUUNNNN
>______NPNNNNUUUUUUNNNN
>______NPNNNNNNNNNNNNNN
>______NPPPPPPPPPPPPNNN
>______NNUUUNNNNNNNPNNN
<______NNUUUNNNNNPPPNNN
>______NNUUUNNNNNPNNNNN
>______NNNNNNNNNNPNNNNN
>______NNNNNNNNNNPPPPPN
>______NNNNNNNNNNNNNNPN
<EPPPPPPPPPPPPPPPPPPPPN
<______NNNNNNNNNNNNNNNN

