NNNNNNNNNN
NPPPPPNNNN
NNNNNPNNNN
NNNNNPPPNN
NNNNNNNNNN