>NNNNNNNNNN
<NNNUNNNNPPS
<NNNUUNPPPN
<NNNNNNPNNN
<NNEPPPPNNN
>NNNNNNNNNN

