<_NNNNNNNNNNNNNNNN
<_NNNNNNNNNNNPPPPPS
<_NPPPPPPPPPPPNNNN
>_NPNNNNNNNNNNNNNN
>_NPNNNNNNNNNNNNNN
>_NPNNNNNNNNNNNNNN
>_NPNNNNNNNNNNNNNN
>_NPPPPPPPPPPPPNNN
>_NNNNNNNNNNNNPNNN
<_NNNNNNNNNNPPPNNN
>_NNNNNNNNNNPNNNNN
>_NNNNNNNNNNPNNNNN
>_NNNNNNNNNNPPPPPN
>_NNNNNNNNNNNNNNPN
<EPPPPPPPPPPPPPPPN
<_NNNNNNNNNNNNNNNN