<NNNNNNNNNNNNNNNN
<NNNNNNNNNNNPPPPPS
<NPPPPPPPPPPPNNNN
>NPNNNNNNNNNNNNNN
>NPNNNNNNNNNNNNNN
>NPNNNNNNNNNNNNNN
>NPNNNNNNNNNNNNNN
>NPPPPPPPPPPPPNNN
>NNNNNNNNNNNNPNNN
<NNNNNNNNNNPPPNNN
>NNNNNNNNNNPNNNNN
>NNNNNNNNNNPNNNNN
>NNNNNNNNNNPPPPPN
>NNNNNNNNNNNNNNPN
<PPPPPPPPPPPPPPPN
<NNNNNNNNNNNNNNNN