<______NNNNNNNNNNNNNNNN
<______NNNNNNNNNNNPPPPPS
<______NPPPPPPPPPPPNNNN
>______NPNNNNNNNNNNNNNN
>______NPNNNNNNNNNNNNNN
>______NPNNNNNNNNNNNNNN
>______NPNNNNNNNNNNNNNN
>______NPPPPPPPPPPPPNNN
>______NNNNNNNNNNNNPNNN
<______NNNNNNNNNNPPPNNN
>______NNNNNNNNNNPNNNNN
>______NNNNNNNNNNPNNNNN
>______NNNNNNNNNNPPPPPN
>______NNNNNNNNNNNNNNPN
<EPPPPPPPPPPPPPPPPPPPPN
<______NNNNNNNNNNNNNNNN