<______NUNNNNNNNNUNNNNN
<______NNNNNNNNNNNPPPPPS
<______NPPPPPPPPPPPNNNN
>______NPNNNNNNNNNNNNNN
>______NPNNNUNNNNNNNNNN
>______NPNNNNNNNNNNNUNN
>______NPNNNNNNNNNNNNNN
>______NPPPPPPPPPPPPNNN
>______NNNNNNNNNNNNPNNN
<______NUNNNNNNNNPPPNNN
>______NNNNNNNNNNPNNNUN
>______NNNNNNNNNNPNNNNN
>______NNNNNNNUNNPPPPPN
>______NNNNNNNNNNNNNNPN
<EPPPPPPPPPPPPPPPPPPPPN
<______NNNNNNNNNNNNNNNU